#########
#S_____S#
#_______#
#_______#
#___G___#
#_______#
#_______#
#S_____S#
#########
