##########
#____G___#
#___##___#
#___##___#
#________#
#_##__##_#
#________#
#_S___S__#
##########
