####################
#S___##__##______###
#_##_#______##_#___#
#_#____#######_#####
#___##_#____#####_##
######_#_##_#__##_##
#___##_#_#__#______#
#_#_##___#_##_####_#
#_#__##_##____##___#
#__#_##_###_######_#
##______###_##G____#
####################
